# #######
#       #
####### #
# # #    
#########